#####################################################
# h                                                 #
#                                                   #
############################################## ######
#                                                   #
#### #################### ###########################
#                                                   #
################################################  ###
#                                                   #
#     ###############################################
####                                                p
#     ###############################################
#                                                   #
#####################################################